S##.................
..#.................
...######...####....
........#...........
........#...........
........#####.......
............#.......
............#.......
............#.......
.........#...#......
..........#...#.....
...........#...#....
...##..####....#....
.#.............#....
.#.............#....
.#......#######.....
.#....#.............
......#.............
..####..............
.........#####......
